###################
# S               #
#  #######  #  #  #
#  #     #  #  #  #
#######  ####  ####
#        #        #
#  #######  ####  #
#  #     #  #     #
#  ####  #  ####  #
#     #     #     #
#  #######  #######
#        #  #  #  #
#  #######  #  #  #
#           #  #  #
#  #######  #  #  #
# E   #           #
###################