###########################################################################################
# E#  #        #                 #           #              #        #  #     #     #  #  #
#  #  #  #  #  #  #  ####  ##########  #######  #  #  #  #  #  #  ####  #  #  #  ####  #  #
#     #  #  #     #     #  #  #        #     #  #  #  #  #     #           #        #     #
#  #  ####  #  ##########  #  #######  #  ####  #  #######  #  ####  ####  #######  #  ####
#  #        #  #           #  #     #           #     #     #  #        #  #  #           #
####  #######  ##########  #  #  #  #  #  #############  #############  #  #  #######  ####
#           #        #     #     #     #  #  #  #     #              #  #  #        #     #
#######  ####  #  #  #######  ####  #######  #  #  ####  ####  #  #  #  #  ####  #  #######
#        #     #  #  #     #     #           #     #  #  #     #  #  #  #  #     #  #  #  #
#  ##########  #  ####  ####  ####  ####  ####  #  #  #######  #######  ####  #  ####  #  #
#  #           #                 #  #  #  #     #           #  #  #  #  #     #  #  #     #
####  ####  ####  #######  ##########  #  #  #############  #  #  #  #  ####  #  #  #  ####
#     #     #  #  #  #           #                       #  #  #        #  #  #  #        #
#  ##########  ####  #############  #  #######  #  ####  #######  #######  #  ####  ####  #
#     #           #  #  #     #  #  #  #     #  #     #  #  #     #  #           #  #     #
#  ####  #  ####  #  #  #  #  #  ####  #  #  #  #######  #  #######  #  ####  ####  #######
#        #  #  #     #  #  #     #  #  #  #     #        #        #     #              #  #
#  ####  ####  #######  #  #######  ####  ####  ##########  #  ####  #  #  #######  #  #  #
#     #  #              #  #  #  #  #     #        #  #     #  #     #  #  #        #  #  #
#  #############  ####  #  #  #  #  #  #  ##########  ####  #  #  #  #  ##########  ####  #
#     #        #  #           #     #  #     #  #     #  #  #     #  #  #     #     #     #
#  ####  ####  #  #############  #  #######  #  #  ####  #  ##########  ####  ####  #  ####
#  #     #                 #  #  #     #  #     #     #     #     #  #        #           #
#  ####  ####  #############  #  #  #  #  #  ####  ####  #  ####  #  #  #######  #  #  ####
#     #     #  #     #     #     #  #  #  #     #        #  #  #  #     #        #  #  #  #
#  #  #  #  ####  ####  #  #  ####  ####  #  ####  ##########  #  ####  #######  #######  #
#  #     #        #     #  #  #           #  #                       #  #        #        #
#######  #######  #  #  ##########  #  #  #  #  #######  #######  #############  #  #  ####
#  #        #        #        #  #  #  #        #  #     #  #  #  #        #        #  #  #
#  ####  ##########  #######  #  ##########  ####  ####  #  #  ##########  ####  #######  #
#        #  #        #  #  #  #        #     #  #                 #                       #
#  ####  #  #  #  ####  #  ####  #  #  #  #  #  ####  #  #  ####  ####  ####  #######  ####
#     #  #  #  #     #  #  #  #  #  #     #        #  #  #     #  #  #  #  #     #  #     #
#  ####  #  ##########  #  #  #######  ####  ##########  ####  #  #  ####  #  #  #  ####  #
#  #  #              #  #        #  #     #        #     #     #  #           #     #     #
#  #  #######  #  #  #  #  #  #  #  #  #######  #############  #  #  #  ####  #############
#  #     #     #  #  #     #  #     #  #  #  #  #        #  #  #  #  #  #        #        #
#######  #  #######  #######  ##########  #  ####  #  ####  ####  ##########  #######  ####
#           #        #  #                 #  #     #     #           #        #           #
####  #  #######  ####  ################  #  #######  ######################  #  #######  #
#     #     #                    #     #  #     #                 #              #        #
#  ####  ####  #  #  ####  ####  ####  #  #  #######  #  ############################  #  #
#  #     #     #  #     #  #  #  #        #  #  #  #  #           #        #  #        #  #
####  ################  #  #  #  #######  #  #  #  ####  #  #  ##########  #  #  #  ####  #
#     #        #  #     #     #                    #     #  #  #     #        #  #  #     #
##########  ####  #  ##########  ####  #  ####  #  #  #  #######  #######  ####  #  #  #  #
#        #                 #        #  #  #     #  #  #  #     #     #     #  #  #  #  #  #
#  #  ##########  #######  #######  #  ####  #  ####  #  ####  #  #  #  #  #  #######  #  #
#  #        #        #  #     #     #  #     #  #  #  #        #  #     #              #  #
#  #  #  ####  #  ####  ####  ####  #  ####  ####  #  #  #  ####  #######  ####  #######  #
#  #  #  #  #  #           #     #  #  #        #  #  #  #        #  #        #  #  #     #
####  #  #  ####  #  ####  #  #######  ####  #  #  #  ####  #  ####  ##########  #  ####  #
#     #  #        #  #     #        #  #  #  #     #  #     #  #              #     #  #  #
####  #  #  #  #############  ####  ####  #  #  ####  ####  #  #  ####  #  #  #  ####  #  #
#     #     #           #        #  #        #     #  #  #  #  #     #  #  #        #  #  #
#  ##########  #######  #######  #  #######  ##########  #  #  ################  ####  #  #
#     #  #     #        #     #  #     #        #           #        #           #     #  #
#  ####  ####  ####  #######  #######  ####  #  ####  #  #######  #  ####  ####  ####  #  #
#        #        #           #        #     #  #     #     #     #  #     #        #   S #
###########################################################################################