########################
######### S    #########
#############   #####
############  #########
##                    ##
##  E                  ##
##########################